250
2
6
traba traba traba traba traba traba traba traba traba traba
traba traba traba traba prova traba traba traba traba prova
prova traba prova traba prova traba prova traba prova traba
prova prova prova prova prova prova prova prova prova prova
final prova prova prova prova final prova prova prova prova final final final
prova final final final final prova final final final final final final final
36 33 0 29
000000000000000000000000000000000000
000000000000000000000000000000000000
000000000000022222222222222222222222
000000000000023222222222222222222223
000000000000022222222222222222222222
000000000000022200000000000000000000
000000000000022200000000000000000000
000000000000022200000000000000000000
000000000000022200000000000000000000
000000000000022200000000000000000000
000000000000022200000000000000000000
000000000000022200000000000000000000
000000000000022200000000000000000000
000000000000022200000000000000000000
000000000000022200000000000000000000
000000000000022200000000000000000000
000000000000022200000000000000000000
000000000000022200000000000000000000
000000000000022200000000000000000000
000000000000022200000000000000000000
000000000000022200000000000000000000
000000000000022200000000000000000000
000000000000022200000000000000000000
000000000000022200000000000000000000
000000000000022200000000000000000000
000000000000022200000000000000000000
000000000000022200000000000000000000
000000000000022200000000000000000000
222222222222222200000000000000000000
222222222222223200000000000000000000
222222222222222200000000000000000000
000000000000000000000000000000000000
000000000000000000000000000000000000
