300
2
8
final traba traba traba traba traba traba traba traba traba prova
final traba prova traba prova traba prova traba prova traba prova
prova traba prova traba prova traba prova traba prova traba prova
final prova prova prova prova final prova prova prova prova prova
final prova prova prova prova final prova prova prova prova final prova prova prova final
prova prova prova prova prova prova prova prova prova prova final prova prova prova final
prova final final final final prova final final final final final prova prova prova final 
final final final final final final final final final final final final final final final
36 33 0 3
000000000000000000000000000000000000
000000000000000000000000000000000000
222222222222222200222222222222222222
222222222222223200232222222222222223
222222222222222200222222222222222222
000000000000022200222000000000000000
000000000000022200222000000000000000
000000000000022200222000000000000000
000000000000022200222000000000000000
000000000000022200222000000000000000
000000000000022200222000000000000000
000000000000022200222000000000000000
000000000000022200222000000000000000
000000000000022200222000000000000000
000022222222222200222222222222220000
000023222222223200232222222222320000
000022222222222200222222222222220000
000022200000000000000000000002220000
000022200000000000000000000002220000
000022200000000000000000000002220000
000022200000000000000000000002220000
000022200000000000000000000002220000
000022200000000000000000000002220000
000022200000000000000000000002220000
000022200000000000000000000002220000
000022200000000000000000000002220000
000022200000000000000000000002220000
000022200000000000000000000002220000
000022222222222222222222222222220000
000023222222222222222222222222320000
000022222222222222222222222222220000
000000000000000000000000000000000000
000000000000000000000000000000000000
